Meret	Nap
Milinkovic-Savic V.	Tor
De Gea	Fio
Maignan	Mil
Sommer	Int
Di Gregorio	Juv
Carnesecchi	Ata
Leali	Gen
Stankovic F.	Ven
Skorupski	Bol
Svilar	Rom
Turati	Mon
Vasquez D.	Emp
Caprile	Cag
Provedel	Laz
Falcone	Lec
Suzuki	Par
Reina	Com
Sava	Udi
Ravaglia F.	Bol
Perin	Juv
Okoye	Udi
Sherri	Cag
Montipo'	Ver
Rui Patricio	Ata
Radu I.	Ven
Scuffet	Nap
Pizzignacco	Mon
Butez	Com
Terracciano	Fio
Joronen	Ven
Rossi F.	Ata
Bagnolini	Bol
Vigorito	Com
Martinelli T.	Fio
Gollini	Rom
Sommariva	Gen
Di Gennaro	Int
Martinez Jo.	Int
Pinsoglio	Juv
Furlanetto	Laz
Mandas	Laz
Fruchtl	Lec
Samooja	Lec
Nava	Mil
Sportiello	Mil
Contini	Nap
Corvi	Par
Paleari	Tor
Padelli	Udi
Grandi	Ven
Berardi A.	Ver
Perilli	Ver
Brancolini	Emp
Ciocci	Cag
Torriani	Mil
Donnarumma An.	Tor
Silvestri	Emp
Mazza	Mon
Marin Re.	Rom
Seghetti	Emp
Piana	Udi
Marcone	Par
Siegrist	Gen
Dumfries	Int
Dimarco	Int
Bastoni	Int
Di Lorenzo	Nap
Carlos Augusto	Int
Zortea	Cag
Tavares N.	Laz
Gosens	Fio
Zappacosta	Ata
Buongiorno	Nap
Rrahmani	Nap
Cambiaso	Juv
Hernandez T.	Mil
Kyriakopoulos	Mon
Delprato	Par
Valeri	Par
Mancini	Rom
Savona	Juv
Ismajli	Emp
Pezzella Giu.	Emp
Dodo'	Fio
De Vrij	Int
Darmian	Int
Gatti	Juv
Angelino	Rom
Bellanova	Ata
Lazaro	Tor
Luperto	Cag
Martin	Gen
Marusic	Laz
Gabbia	Mil
Kalulu	Juv
Gigot	Laz
Ruggeri	Ata
Beukema	Bol
Lykogiannis	Bol
Miranda J.	Bol
Viti	Emp
Cacace	Emp
Valenti	Par
Masina	Tor
Bijol	Udi
Kamara H.	Udi
Walker	Mil
Holm	Bol
Obert	Cag
Ranieri L.	Fio
Bisseck	Int
Gila	Laz
Olivera	Nap
Spinazzola	Nap
N'Dicka	Rom
Zemura	Udi
Idzes	Ven
Pavlovic	Mil
Hien	Ata
De Silvestri	Bol
Zappa	Cag
Augello	Cag
Vasquez	Gen
Bremer	Juv
Coco	Tor
Tchatchoua	Ver
Maripan	Tor
Djimsiti	Ata
Mina	Cag
Parisi	Fio
De Winter	Gen
Zanoli	Gen
Sabelli	Gen
Pavard	Int
De Sciglio	Emp
Lazzari	Laz
Hysaj	Laz
Gaspar K.	Lec
Gallo	Lec
Tomori	Mil
Pereira P.	Mon
Birindelli	Mon
Ehizibue	Udi
Cuadrado	Ata
Kempf	Com
Solet	Udi
Lucumi'	Bol
Dossena	Com
Goglichidze	Emp
Comuzzo	Fio
Acerbi	Int
Zampano	Ven
Emerson Royal	Mil
Sosa B.	Tor
Rensch	Rom
Kelly L.	Juv
Kolasinac	Ata
Moreno Alb.	Com
Walukiewicz	Tor
Biraghi	Tor
Bani	Gen
Vogliacco	Par
Cabal	Juv
Romagnoli	Laz
Pellegrini Lu.	Laz
Baschirotto	Lec
Juan Jesus	Nap
Balogh	Par
Kabasele	Udi
Svoboda	Ven
Sverko	Ven
Palomino	Cag
Jimenez A.	Mil
Sergi Roberto	Com
Jean	Lec
Leoni	Par
Guilbert	Lec
Kossounou	Ata
Van Der Brempt	Com
Posch	Ata
Thiaw	Mil
Izzo	Mon
Mari'	Fio
Celik	Rom
Vojvoda	Com
Kristensen T.	Udi
Coppola D.	Ver
Ghilardi	Ver
Erlic	Bol
Haps	Ven
Pedersen	Tor
Hummels	Rom
Alberto Costa	Juv
Nelsson	Rom
Toloi	Ata
Goldaniga	Com
Patric	Laz
Calabria	Bol
Carboni A.	Mon
Bradaric	Ver
Daniliuc	Ver
Toure' I.s.	Udi
Valle	Com
Smolcic I.	Com
Scalvini	Ata
Pongracic	Fio
Marcandalli	Ven
Matturro	Gen
Casale	Bol
Terracciano F.	Mil
Caldirola	Mon
D'Ambrosio	Mon
Mazzocchi	Nap
Giannetti L.	Udi
Dawidowicz	Ver
Faraoni	Ver
Abdulhamid	Rom
Schingtienne	Ven
Carboni F.	Ven
Moreno M.	Fio
Bartesaghi	Mil
Ahanor	Gen
Valentini N.	Ver
Lovik	Par
Otoa	Gen
Candè	Ven
Oyegoke	Ver
Veiga D.	Lec
Brorsson	Mon
Provstgaard	Laz
Salah-Eddine	Rom
Iovine	Com
Sala M.	Lec
Ebuehi	Emp
Marin R.	Nap
Circati	Par
Osorio	Par
Sangare' B.	Rom
Sazonov	Emp
Schuurs	Tor
Okou	Ver
Frese	Ver
Sagrado	Ven
Rouhi	Juv
Marianucci	Emp
Norton-Cuffy	Gen
Dembele' A.	Tor
Palestra	Ata
Palacios T.	Mon
Sambia	Emp
Florenzi	Mil
Jack	Com
Lekovic	Mon
Tiago Gabriel	Lec
Slotsager	Ver
Scott	Lec
Pulisic	Mil
Zaccagni	Laz
Orsolini	Bol
Reijnders	Mil
Barella	Int
Zambo Anguissa	Nap
McTominay	Nap
Neres	Nap
Paz N.	Com
Ndoye	Bol
Strefezza	Com
Man	Par
Calhanoglu	Int
Frattesi	Int
Thuram K.	Juv
Weah	Juv
Adli	Fio
El Shaarawy	Rom
Ederson D.s.	Ata
Nicolussi Caviglia	Ven
Saelemaekers	Rom
Dele-Bashiru	Laz
Samardzic	Ata
Conceicao	Juv
Zielinski	Int
Politano	Nap
Vlasic	Tor
Oristanio	Ven
Brescianini	Ata
Kone' M.	Rom
De Roon	Ata
Koopmeiners	Juv
Marin	Cag
Mkhitaryan	Int
Hernani	Par
Freuler	Bol
McKennie	Juv
Guendouzi	Laz
Tete Morente	Lec
Sohm	Par
Lovric	Udi
Ellertsson	Ven
Fadera	Com
Zaniolo	Fio
Fabbian	Bol
Ferguson	Bol
Gyasi	Emp
Frendrup	Gen
Cataldi	Fio
Paredes	Rom
Lazovic	Ver
Fofana Y.	Mil
Anjorin	Emp
Pasalic	Ata
Felici	Cag
Da Cunha	Com
Bianco	Mon
Colpani	Fio
Locatelli	Juv
Miretti	Gen
Gaetano	Cag
Bove	Fio
Pellegrini Lo.	Rom
Ricci S.	Tor
Gineitis	Tor
Pisilli	Rom
Diao	Com
Sottil	Mil
Douglas Luiz	Juv
Rovella	Laz
Ciurria	Mon
Maldini	Ata
Busio	Ven
Ekkelenkamp	Udi
Elmas	Tor
Casadei	Tor
Viola	Cag
Fazzini	Emp
Mandragora	Fio
Badelj	Gen
Loftus-Cheek	Mil
Chukwueze	Mil
Lobotka	Nap
Baldanzi	Rom
Henderson L.	Emp
Asllani	Int
Vecino	Laz
Bernabe'	Par
Cristante	Rom
Ilic	Tor
Zerbin	Ven
Caqueret	Com
Cornet	Gen
Moro N.	Bol
Musah	Mil
Kastanos	Ver
Harroui	Ver
Engelhardt	Com
Coulibaly L.	Lec
Hainaut	Par
Martins K.	Mon
Ondrejka	Par
Urbanski	Mon
Karlsson	Lec
Adopo	Cag
Ikone'	Com
Ramadani	Lec
Maleh	Emp
Pobega	Bol
Bondo	Mil
Payero	Udi
Belahyane	Laz
Serdar	Ver
Karlstrom	Udi
Sensi	Mon
Perez K.	Ven
Deiola	Cag
Makoumbou	Cag
Thorsby	Gen
Messias	Gen
Pierret	Lec
Pessina	Mon
Camara D.	Par
Linetty	Tor
Tameze	Tor
Duda	Ver
Suslov	Ver
Perrone	Com
Yeboah J.	Ven
Atta	Udi
Grassi	Emp
Tchaouna	Laz
Rafia	Lec
Folorunsho	Fio
Zalewski	Int
Richardson	Fio
Berisha M.	Lec
Helgason	Lec
Keita M.	Par
Masini	Gen
Billing	Nap
Veiga R.	Juv
Onana J.	Gen
Ndour	Fio
Gourna-Douath	Rom
Aebischer	Bol
Malinovskyi	Gen
Fagioli	Fio
Castrovilli	Mon
Kaba	Lec
Zarraga	Udi
Duncan	Ven
Doumbia I.	Ven
Rui Modesto	Udi
Gilmour	Nap
Ibrahimovic A.	Laz
Bernede	Ver
Sulemana I.	Ata
Prati	Cag
Braunoder	Com
Haas	Emp
Vignato S.	Mon
Bjarkason	Ven
Zurkowski	Emp
Alli	Com
Kovalenko	Emp
El Azzouzi	Bol
Jankto	Cag
Akpa Akpro	Mon
Marchwinski	Lec
Zeroli	Mon
Gagliardini	Mon
Forson O.	Mon
Estevez	Par
Crnigoj	Ven
Adzic	Juv
Liberali	Mil
El Haddad	Ven
Cassa	Ata
Byar	Bol
Cisse' A.	Ver
Manzoni	Ata
Vos	Mil
Hasa	Nap
Basic	Laz
Kasa	Gen
Pafundi	Udi
Condè	Ven
Niasse	Ver
Cuenca H.	Gen
Thuram	Int
Retegui	Ata
Lookman	Ata
Kean	Fio
Gimenez	Mil
Martinez L.	Int
Lukaku	Nap
Castellanos	Laz
Vlahovic	Juv
Dybala	Rom
De Ketelaere	Ata
Esposito Se.	Emp
Dovbyk	Rom
Dia	Laz
Yildiz	Juv
Leao	Mil
Lucca	Udi
Castro S.	Bol
Adams C.	Tor
Beltran L.	Fio
Gudmundsson A.	Fio
Thauvin	Udi
Kolo Muani	Juv
Tengstedt	Ver
Odgaard	Bol
Cutrone	Com
Krstovic	Lec
Pinamonti	Gen
Piccoli	Cag
Colombo	Emp
Zapata D.	Tor
Pedro	Laz
Djuric	Par
Dominguez B.	Bol
Mota	Mon
Bonny	Par
Mosquera	Ver
Mbangula	Juv
Sarr A.	Ver
Scamacca	Ata
Isaksen	Laz
Noslin	Laz
Dallinga	Bol
Gonzalez N.	Juv
Pierotti	Lec
Joao Felix	Mil
Caprari	Mon
Cancellieri	Par
Simeone	Nap
Davis K.	Udi
Almqvist	Par
Coman F.	Cag
Abraham	Mil
Fila	Ven
Charpentier	Par
Pellegri	Emp
Bravo	Udi
Karamoh	Tor
Shomurodov	Rom
Haj Mohamed	Par
Douvikas	Com
Keita B.	Mon
Luvumbo	Cag
Ekuban	Gen
Arnautovic	Int
Taremi	Int
Mihaila	Par
Ekhator	Gen
Ganvoula	Mon
Pavoletti	Cag
Okafor	Nap
Brenner	Udi
Balotelli	Gen
Kouame'	Emp
Vitinha O.	Gen
Soule'	Rom
Sanabria	Tor
Rocha Livramento	Ver
Correa	Int
Rebic	Lec
Banda	Lec
Raspadori	Nap
Gytkjaer	Ven
Njie	Tor
Salama	Tor
Cambiaghi	Bol
Gabrielloni	Com
Camarda	Mil
Sanchez	Udi
N'Dri	Lec
Pellegrino M.	Par
Azon	Com
Mutandwa	Cag
Burnete	Lec
Jovic	Mil
Petagna	Mon
Ngonge	Nap
Benedyczak	Par
Solbakken	Emp
Lambourde	Ver
Pedrola	Bol
Milik	Juv
Pizarro	Udi
Maric	Ven
Kowalski	Par
Vlahovic V.	Ata
Sansone	Lec